[MAP]
 , , , , , , , , , , , , , , , , , , , , , , , , , , , , , , , , , , , , , , , , ,U, , , , , , , , , , , , , , , , , , , , , , ,
 , , , , , , , , , , , , , , , , , , , , , , , , , , , , , , , , , , , , , , , , , , , , , , , , , , , , , , , , , , , , , , , ,
 , , , , , , , , , , , , , , , , , , , , , , , , , , , , , , , , , , , , , , , , , , , , , , , , , , , , , , , , , , , , , , , ,
 , , , , , , , , , , , , , , , , , , , , , ,B, ,B, ,B, ,B, ,B, ,B, ,B, ,B, ,B, ,B, ,B, ,B, ,B, ,B, ,B, ,B, ,B, ,B, ,B, ,B, , , ,
 , , , , , , , , , , , , , , , , , , , , , , , , , , , , , , , , , , , , , , , , , , , , , , , , , , , , , , , , , , , , , , , ,
 , , , , , , , , , , , , , , , , , , , , , ,X, , , , , , , , , , , ,X, , , , , , , , , , , , , , , , , , , , , , , , , ,X, , , ,
 , , , , , , , , , , , , , , , , , , , , , , , , ,U, , , ,U, , , , , , , , , , , , , , , , , , , , , , , , , , , , , , , , , ,U,
 , , , , , , , , , , , , , , , , , , , , , ,X, , , , , , , , , , , ,X, , , , , , , , , ,X, , , , , , , , , , , , , , , ,X, , , ,
 , , , , , , , , , , , , , , , , , , , , , , , , , , , , , , , , , , , , , , , , , , , , , , , , , , , , , , , , , , , , , , , ,
 , , , , , , , , , , , , , , , , , , , , , ,X, , , , , , , , , , , ,X, , , , , , , , , ,X, , , , , , , , , , , , , , , ,X, , , ,
 , , , , , , , , , , , , , , , , , , , , , , , , , , , , , , , , , , , , , , , , , , , , , , , , , , , , , , , , , , , , , , ,U,
 , , , , , , , , , , , , , , , , , , , , , ,B, , , , , , , , , , , ,X, , , , , , , , , ,B, ,B, ,B, ,B, ,B, ,B, ,B, ,B, ,B, , , ,
 , , , , , , , , , , , , , , , , , , , , , , , , , , , , , , , , , , , , , , , , , , , , , , , , , , , , , , , , , , , , , , , ,
 , , , , , , , , , , , , , , , , , , , , , ,X, , , , , , , , , , , ,B, , , , , , , , , ,X, , , , , , , , , , , , , , , ,X, , , , 
 , , , , , , , , , , , , , , , , , , , , , , , , , , , , , , , , , , , , , ,U, ,U, , , , , , , , , , , , , , , , , , , , , , , ,
 , , , , , , , , , , , , , , , , , , , , , ,X, , , , , , , , , , , ,X, , , , , , , , , ,X, , , , , , , , , , , , , , , ,X, , ,U, 
 , , , , , , , , , , , , , , , , , , , , , , , , , , , , , , , , , , , , , , , , , , , , , , , , , , , , , , , , , , , , , , , , 
 , , , , , , , , , , , , , , , , , , , , , ,X, , , , , , , , , , , ,X3, , , , , , , , , , , ,B, ,B, ,B, ,B, ,B, ,B, ,B, ,B, , , ,
 , , , , , , , , , , , , , , , , , , , , , , , , , , , , , , , , , , , , , , , , , , , , , , , , , , , , , , , , , , , , , , , ,
 , , , , , , , , , , , , , , , , , , , , , ,X, , , , , , , , , , , ,X, , , , , , , , , ,X2, , , , , , , , , , , , , , , ,X, , ,U,
 , , , , , , , , , , , , , , , , , , , , , , , , , , , , , , , , , , , , , , , , , , , , , , , , , , , , , , , , , , , , , , , ,
 , , , , , , , , , , , , , , , , , , , , , ,X, , , , , , , , , , , ,X, , , , , , , , , ,X, , , , , , , , , , , , , , , ,X, , , ,
 , , , , , , , , , , , , , , , , , , , , , , , , , , , , , , , , , , , , , , , , , , , , , , , , , , , , , , , , , , , , , , , ,
 , , , , , ,C, , , , , , , , , , , , , , , ,X, , , , , , , , , , , ,B, , , ,U, ,U, , , ,X, ,B, ,B, ,B, ,B, ,B, ,B, ,B, ,B, , , ,
 , , , , , , , , , , , , , , , , , , , , , , , , , , , , , , , , , , , , , , , , , , , , , , , , , , , , , , , , , , , , , , , ,
B, ,B, ,B, ,B, ,B, ,W, ,W, ,W, ,B, ,B, ,B, ,B, ,B, ,B, ,B, ,B, ,B, ,B, ,B, ,B, ,B, ,B, ,B, ,B, ,B, ,B, ,B, ,B, ,B, ,B, ,B, ,W, ,W, ,W, ,W,
[MAPEND]

