[MAP]
BG,B,B,B,B,B,B,B,B,B,B,B,B,B,B,B,B,B,B,B,B,B,B,B,B
B, ,C, , , , , , , ,X, , , , , , , , , , ,L, , ,B
B, , , , , , , , , ,X, , , , , , , , , , ,L, , ,B
B, ,F, , , , , , , ,X, , , , , , , , , , ,L,E1, ,B
B, , , , , , , , ,B,B,B, , , , , , ,B, , ,B,B,B,B
B, , , ,X, , , , ,B,F,F, , ,B, , , , , , , , , ,B
B, , ,X,X,X, , , ,B,F,F, , , , , , , , , , ,K, ,B
B,B,B,B,B,B,B,B,B,B,B,B,B,B,B,B,B,B,B,B,B,B,B,B,B
[MAPEND]
