[MAP]
B,B,B,B,B,B,B,B,B,B,B,B,B,B,B,B,B,B,B,B,B,B,B,B,B
B, , , , , , , , , , , , , , ,T, , , , , , , , ,B
B, , , , , , , , , , , , , ,X, ,X, , , , , , , ,B
B, , , , , , , , , , , , , ,X, ,X, , , , , , , ,B
B, , , , , , , , , , , , , , ,R, , , , , , , , ,B
B, ,C, , , , , , , , , , , ,X, ,X, , , , , , , ,B
B, , , , , , , , , , , , , ,X, ,X, , , , , , , ,B
B,B,B,B,B,B,B,B,B,B,B,B,B,B,B,B,B,B,B,B,B,B,B,B,B
[MAPEND]