[MAP]
B,B,B,B,B,B,B,B,B,B,B,B,B,B,B,B,B,B,B,B,B,B,B,B,B
B,PB, , , , ,B, , ,B,F,X,F,B,F,X,F,B,F,X,F,B,L, ,B
B, ,K, , , ,B, , ,B, ,X, ,B, ,X, ,B, ,X, ,B,L, ,B
B,B,B,B,B, ,L, , ,L,L,L,L,L,L,L,L,L,L,L,L,L,L, ,B
B, , , , , ,L, , , ,F, ,F, ,F, ,F, ,F, ,F, ,L,E2,B
B,C, , ,B,B,B, , ,X, ,X, ,X, ,X, ,X, ,X, ,X,L, ,B
B, , , , , ,L, , ,X,F,X,F,X,F,x,F,X,F,X,F,X,L, ,B
B,B,B,B,B,B,B,B,B,B,B,B,B,B,B,B,B,B,B,B,B,B,B,B,B
[MAPEND]
